.........
..#.#....
..#.###..
..#.#....
..#######
.........
..####.#.
.....#.#.